R 1920 1080

NO ./texture/N_WALL.xpm
EA ./texture/E_WALL.xpm
SO ./texture/S_WALL.xpm
WE ./texture/W_WALL.xpm

S ./texture/SPRITE.xpm

F 250,250,250
C 150,230,250

        1111111111111111111111111
        1000000000110000000000001
        1011000001110000002000001
        1001000000000000000000001
111111111011000001110000000000001
100000000011000001110111111111111
11110111111111011100000010001
11110111111111011101010010201
11000000110101011100000000001
10002000000000001100000010001
10000000000000001101010010001
11000001110101011111011110N0111
11110111 1110101 101111010001
11111111 1111111 111111111111
